0 0 30 35 43 43 43 43 43 32 28 39 0 0 1 0 0 0 0 0 0 0 0 0 43 0 0 0 0 0 38 28 28 28 28 28 28 39 0 0 0 0 0 0 0 0 0 0 0 0 
35 1 0 36 35 0 0 0 0 0 0 32 28 28 39 0 1 38 28 28 28 28 28 39 0 0 0 0 0 38 33 0 0 0 0 0 0 32 28 28 28 28 28 39 0 0 38 28 28 39 
36 30 35 0 29 0 0 8 9 0 0 0 0 0 32 28 28 33 0 0 0 0 0 31 0 0 38 28 28 33 0 0 0 0 0 0 0 0 0 0 0 0 0 32 28 28 33 0 0 31 
0 43 36 35 36 35 1 5 3 0 0 0 0 0 0 0 0 0 0 0 0 0 0 32 28 28 33 0 0 0 43 43 0 0 0 0 0 0 0 0 0 0 0 0 0 0 0 0 0 31 
42 0 0 29 0 29 0 5 11 9 0 22 18 18 18 23 0 0 0 0 0 0 0 0 0 0 0 0 0 0 0 43 43 0 0 0 0 0 0 0 0 0 0 0 0 0 0 0 0 31 
0 42 0 29 1 36 35 5 10 3 22 25 15 15 15 24 23 0 0 0 0 0 0 0 0 0 43 0 0 0 0 0 0 0 43 43 43 43 0 43 43 43 0 0 0 0 0 0 0 31 
0 0 1 36 35 0 29 5 10 3 19 15 15 15 15 15 17 0 0 43 43 0 0 0 0 0 0 0 0 43 43 43 43 43 0 0 0 0 0 0 0 43 0 0 0 0 0 0 34 37 
43 1 0 38 33 0 29 5 10 3 20 16 27 15 15 26 21 0 0 43 0 0 0 0 43 43 0 43 43 43 43 43 43 0 0 0 0 0 0 43 0 0 0 0 0 0 0 1 31 1 
0 38 28 33 0 38 33 5 10 3 0 0 20 16 16 21 0 0 43 0 0 0 0 43 43 0 43 43 0 0 0 43 43 43 43 1 43 43 43 43 0 0 0 0 0 0 0 34 37 0 
28 33 0 0 38 33 0 5 10 3 0 0 0 0 0 0 0 0 0 0 0 0 0 43 0 43 43 0 0 0 0 43 43 0 0 0 0 0 43 0 43 43 43 43 0 0 0 31 0 0 
0 0 38 28 33 0 0 5 10 11 9 0 0 0 0 0 0 0 1 0 0 0 0 43 43 0 0 0 43 0 0 0 43 0 0 0 0 0 43 43 0 0 0 0 0 0 0 31 0 0 
28 28 33 0 0 0 0 6 14 10 11 9 0 0 0 0 0 0 0 0 43 43 43 0 43 43 0 0 0 0 0 0 43 0 0 0 0 0 0 43 43 0 0 0 0 0 34 37 0 0 
42 0 0 0 0 0 0 0 6 14 10 11 9 0 0 0 0 0 43 43 43 0 0 0 0 0 43 43 43 43 43 43 43 0 0 0 0 0 0 0 43 43 0 0 0 0 31 0 0 0 
42 0 0 0 0 0 0 0 0 6 14 10 11 9 0 0 0 0 0 0 0 0 0 0 0 0 0 0 0 0 0 0 0 0 0 0 43 0 0 0 0 0 43 43 0 34 37 0 0 0 
35 0 0 0 0 0 0 0 0 0 5 10 10 11 4 9 0 0 0 0 0 0 0 0 0 0 0 0 0 0 0 0 0 0 0 0 0 0 0 0 0 0 0 0 0 32 39 0 0 0 
29 0 0 0 0 0 0 0 0 0 6 2 14 10 10 3 1 0 1 0 0 0 0 0 0 0 0 0 0 0 0 0 0 0 0 0 0 0 0 0 0 0 0 0 0 0 32 28 39 0 
36 30 35 0 0 0 0 0 0 0 0 0 6 2 14 11 4 9 0 0 0 0 0 0 0 0 0 0 0 0 0 0 0 0 0 0 0 0 0 0 0 0 0 43 0 0 0 0 31 0 
0 0 36 35 0 0 0 0 0 0 0 0 0 0 6 14 10 11 9 0 0 0 0 0 0 0 0 0 0 0 0 0 0 0 0 0 0 0 0 0 0 0 43 43 0 0 0 0 31 0 
0 0 0 29 0 0 43 43 0 0 0 0 0 0 0 5 10 10 11 4 4 9 0 0 0 0 0 0 0 0 0 0 0 0 0 0 0 0 0 0 1 1 43 0 0 0 0 0 31 0 
0 0 0 36 35 0 0 0 43 43 0 0 0 0 8 12 10 10 10 10 10 11 4 4 4 4 4 9 0 0 0 0 0 0 0 0 0 0 0 0 43 43 0 0 0 0 0 34 37 0 
0 0 0 0 36 35 0 0 0 43 0 0 0 0 5 10 10 13 2 14 10 10 10 10 10 10 10 11 4 4 9 0 0 1 0 0 0 0 0 43 43 0 0 0 0 0 0 31 0 0 
0 0 0 0 0 36 35 0 0 0 43 0 0 8 12 10 13 7 0 6 2 2 2 2 2 2 14 10 10 10 11 9 0 0 0 0 0 0 0 0 0 0 0 0 0 0 34 37 0 0 
0 0 0 0 0 0 29 0 0 0 43 0 0 5 10 13 7 0 0 0 0 0 0 0 0 0 6 2 2 14 10 11 9 0 0 0 0 0 0 0 0 0 0 0 0 0 31 0 0 0 
0 0 0 0 0 0 29 0 0 0 43 0 0 5 10 3 0 0 0 43 43 43 43 0 0 0 0 0 0 6 14 10 11 9 0 0 0 0 43 43 0 0 0 0 0 0 31 0 0 0 
0 0 0 0 0 0 29 0 0 0 0 0 8 12 10 3 0 0 43 43 0 0 43 43 43 43 43 43 0 0 6 14 10 3 0 0 0 0 0 43 43 0 0 0 0 0 31 0 0 0 
0 0 0 0 0 0 29 0 0 0 0 0 5 10 13 7 0 43 43 43 43 1 1 0 0 0 0 43 43 0 0 5 10 3 0 0 0 0 0 0 43 43 0 0 0 34 37 0 0 1 
0 0 0 0 0 38 33 0 0 0 0 0 5 10 3 0 0 43 0 43 43 42 43 43 1 43 0 0 43 43 0 5 10 3 0 0 0 0 0 0 0 43 43 0 0 31 0 0 0 0 
0 0 0 0 1 29 0 0 0 0 0 0 5 10 3 0 0 43 0 43 43 0 0 0 0 43 43 43 43 43 8 12 10 3 0 0 0 0 0 0 0 0 0 0 0 32 39 0 0 0 
0 0 0 38 28 33 0 0 0 0 0 0 5 10 3 0 0 43 43 0 43 43 1 43 43 43 43 43 43 42 5 10 10 3 0 0 0 0 0 43 43 0 0 0 0 0 32 39 0 0 
0 38 28 33 0 0 0 0 0 43 43 0 5 10 11 9 0 0 43 43 43 43 0 0 0 0 43 43 42 0 6 14 10 3 0 0 0 0 0 0 43 43 0 0 0 0 0 31 0 0 
0 29 0 0 0 0 0 0 43 43 0 0 5 10 10 11 9 0 0 43 43 43 43 43 1 43 43 43 42 0 0 5 10 11 4 4 9 0 0 0 0 0 43 43 0 0 0 31 0 0 
0 29 0 0 0 0 43 43 0 0 0 8 12 10 10 10 11 9 0 0 0 0 42 42 0 0 0 43 43 0 0 5 10 10 10 10 3 0 0 0 0 0 0 43 0 0 0 31 0 0 
0 29 0 0 0 43 43 0 8 4 4 12 10 10 10 10 10 11 4 4 4 4 4 9 0 0 0 43 43 0 8 12 10 13 14 10 11 9 0 0 0 0 43 43 0 0 34 37 0 0 
0 29 0 0 0 43 0 8 12 10 10 10 10 13 2 2 14 10 10 10 10 10 10 11 9 0 0 43 43 43 5 10 13 7 6 2 14 3 0 0 0 0 43 0 0 34 37 0 0 0 
0 29 0 0 0 0 8 12 10 10 13 2 2 7 0 0 6 2 2 2 2 14 10 10 11 9 0 0 0 0 5 10 3 0 0 8 12 3 0 0 0 0 43 0 34 37 0 0 0 0 
0 36 30 35 0 8 12 10 10 13 7 0 43 43 43 43 43 43 43 0 0 6 14 10 10 11 9 0 0 0 5 10 3 0 0 5 10 3 0 0 0 0 0 0 31 0 0 0 0 0 
0 0 0 29 0 5 10 10 13 7 43 43 43 0 0 0 0 0 43 43 43 0 6 14 10 10 11 9 0 8 12 10 3 0 0 5 13 7 0 0 0 0 0 0 31 0 0 0 0 0 
0 0 0 29 0 5 10 13 7 43 43 22 18 18 18 18 18 18 23 0 43 43 0 6 14 10 10 11 4 12 10 13 7 0 0 6 7 0 0 0 0 0 0 34 37 0 0 0 0 43 
0 0 0 36 35 6 14 3 43 43 0 19 15 15 15 15 15 15 24 18 23 43 43 0 6 2 14 10 10 10 13 7 0 0 0 0 0 0 0 0 0 0 0 31 0 0 0 0 43 43 
0 0 0 0 29 0 6 7 0 0 22 25 15 15 15 15 15 15 15 15 17 0 0 0 43 0 6 2 2 2 7 0 0 38 41 0 41 28 39 0 0 0 34 37 0 0 0 43 43 43 
0 0 0 0 29 0 0 0 0 22 25 15 15 15 15 15 15 15 15 15 17 0 0 0 43 0 0 0 0 0 0 38 28 33 43 0 0 0 32 28 39 0 31 0 0 0 43 43 43 43 
0 0 0 0 29 0 0 0 0 19 15 15 15 15 15 15 15 15 15 15 17 0 0 0 0 43 43 0 0 0 0 29 0 0 43 0 0 43 0 0 32 39 31 0 0 0 43 43 43 43 
0 0 0 38 33 0 0 0 0 20 27 15 15 15 15 15 15 15 15 26 21 0 0 0 0 0 0 0 0 0 38 33 0 43 43 43 0 43 43 0 0 31 31 0 0 0 43 0 0 0 
0 0 38 33 0 0 0 0 0 0 20 16 16 27 15 15 15 15 15 17 0 0 0 43 43 0 0 0 0 0 29 0 43 43 43 43 0 0 43 0 34 37 31 0 0 0 43 43 43 0 
0 0 29 0 0 0 0 0 0 0 0 0 0 20 16 16 16 16 16 21 0 0 43 43 0 0 0 0 43 0 29 0 0 0 0 43 0 43 43 0 31 0 32 39 0 0 0 0 0 0 
0 0 29 0 0 0 0 0 0 0 0 0 0 0 0 0 0 0 0 0 0 43 43 0 0 0 0 0 0 0 36 30 30 35 0 0 0 0 0 34 37 0 0 31 0 0 0 0 0 43 
0 0 29 0 0 0 0 0 0 0 34 30 35 0 0 0 0 0 0 0 0 0 0 34 30 30 35 0 0 0 0 0 0 36 30 30 30 30 30 37 0 0 0 31 0 0 0 0 0 43 
0 0 29 0 34 30 30 30 30 30 37 0 36 30 30 30 30 35 0 0 0 34 30 37 0 0 36 30 30 35 0 0 0 34 30 30 30 30 35 0 0 0 0 31 0 0 0 0 0 0 
0 0 36 30 37 0 0 0 0 0 0 0 0 0 0 0 0 36 30 30 30 37 1 0 0 0 0 0 0 36 30 30 30 37 0 0 0 0 36 30 30 30 30 37 0 0 0 0 0 0 
0 0 1 0 0 0 0 0 0 0 0 0 0 0 0 0 0 0 0 0 0 0 0 0 0 0 0 0 0 0 0 0 0 0 0 0 0 0 0 0 0 0 1 0 0 0 0 43 43 0 
